absurd		ab(否定) + surd (相信) -> 不相信
domestic	dome(=home) 
		dom 房屋 + estic …的 → 在房子里的 → 家里的
embody		em 使… + body 身体 → 使〔身体〕显现出来 → 体现
vein		n.  静脉;叶脉;翅脉;纹理;纹路;条纹
stern		adj.  严厉的;苛刻的;要求别人服从的;严峻的;难对付的
		n.  船尾

ensue		接着发生;因而产生
prevention	pre 预先 + vent 来 → 预先来到 → 抢先一步，防止别人先到 → 防止
inhibit		in 不能 + hibit 有；拿 → 不能拿 → 阻止;阻碍;抑制;使拘束;使尴尬
parliament	par(=bar:说话)+lia(添加字符)+ment(抽象名称后缀)   讨论的地方->议会，国会
parade		par->part（部分）+ ad(加)   国家的部分人组织在一起出来
scale		scar->scale  刻->刻度->等级->比例，规模，磅秤，鱼鳞
rein		缰绳->控制
abundance	=flourish =thrive =boom = bloom		大量->富裕
delicate	delicious (好吃的:实物好吃而诱人) a. 精美的(做工精美而诱人)->需要精细处理的，微秒的
mill		n.磨坊 v.碾碎
consensus	共同的感受->同感->一致同意
cohesive	结成一个整体的;使结合的;
tug		用力拖拉
nitrogen	氮气
jam		果酱
responsive	反应敏捷;反应积极
shrewd		精明的;敏锐的;有眼光的;精于盘算的;判断得准的;高明的

interpret	inter(in的比较级：进入，在中间)+pret(=price) 买卖双方的中介，谈判者->延伸（口译）->解释，诠释
interpretor	口译人员
translator	笔译人员
interpretation	
disaster	dis + aster[希腊语](=star)   反方向的星星 ->灾难
confidant	con(共同)+fid(相信)+ant(adj/n) 共同相信的人->n.知心朋友->n.闺蜜
confident	con(共同)+fid(相信)+ent(adj/n) 共同相信的->a.自信的
establishment	stand + stable + ish + ment   v.建立创立
strike		打,击,打击
sabotage	没办法->怠工,蓄意破坏，故意阻挠



