
pref	
-ate		形容词后缀
-age		行为或行为的结果

con-		n.和,共,全
op-		n.工作，操作
opt-		v.选择
de-		加强
re-		一再
ac-		加强（多倾向于他人）
pro-		专业的，赞成的
pre-		预先
per-		每次
im-		不

tran-
前缀trans有两个意思：
1．表示"转变"、"变换"。		
	例如：transport（运输---从一地转到另一地） transplant（移植）translation（翻译---从一种语言转为另一种语言）trans- form（使变形，改造）。
2．表示"超过"、"横跨"、"超"。
	例如：transcentury（跨世纪）transnational（跨国的）transcontinental（横跨大陆的） transatlantic（横跨大西洋的）。

-ture		表示行为、行为的结果以及与行为有关之物
-ist		某种主义的信仰者
-uish		动词，延伸

proper		专业的每次	adj.适合的，适用的

app		n.应用程式
laud		v.赞美
applaud		v.像应用程式一样的赞美 鼓掌
applause	n.鼓掌，掌声

notice      	注意
noticeable  	明显的，显而易见的，显著

origin      	n.起源地
original    	adj.起源
originate   	v. 起源  开创


sea
weed		n.杂草
seeweed		n.海草，海藻

punch		v.已拳重击，穿孔
puncture	n.（已拳重击）的结果-->击穿



pro		赞成
secute		（使不安全）,追责，割断（关系）
prosecute	检举，指控

opt		选择的
im		不
optim		{不选择的},最好的
optimist	乐观主义者


miss		想念
mission		使命，任务
emission	排放物，放射物

im
mense		n.测量
immense		adj.无法测量的	深不可测的 -> 广大的 巨大的

pro		专业的
fume		烟
profume		香水

spectate	出席观看
spectator	n.观众，旁观者，目击者


dis
sting		叮，咬，蛰	
disting		v.从不同的地方叮咬	-> 标记	->	distinguish	v.区分


re		重新
sure		肯定
rect		直，立 == right
resurect	再次立起来	-> 复兴


vol		意愿
volition	意志力

con		共
vert		变
convert		使转变
conversion	n.转变
   version	n.版本

词根   tract= to draw 拉, 拖
abstract v. 提炼    
	abs 离去 + tract 拉，拖 → 拉出 → 提炼       
abstract adj. 抽象的       
abstract n. 抽象派艺术作品；摘要             
attract v. 吸引    
	at 加强 + tract 拉，拖 → 不断拉 → 吸引            
attractive adj. 有吸引力的    
	attract 吸引 + ive …的 → 有吸引力的             
contract n. 契约 
contract v. 收缩    
	con 加强 + tract 拉，拖 → 共同拉〔回去〕→ 收缩             
detract v. 降低；贬损    
	de 向下 + tract 拉，拖 → 向下拉 → 降低             
distract v. 分散；使混乱    
	dis 分离 + tract 拉，拖 → 被拉开 → 分散             
distracted adj. 心烦意乱的    
	distract 分散；使混乱 + ed 表形容词 → 心烦意乱的             
extract v. 抽出；提炼出    
	ex 出 + tract 拉，拖 → 拉出来 → 提炼出             
protract v. 延长    
	pro 向前 + tract 拉，拖 → 向前拉 → 延长             
protractile adj. 可延长的    
	protract 延长 + ile 可…的 → 可延长的             
retract v. 退缩；缩进    
	re 向后 + tract 拉，拖 → 向后拉 → 退缩；缩进             
subtract v. 减去；扣除    
	sub 下 + tract 拉，拖 → 拉下去 → 减去             

tract n. 一片土地；地带（拉长的一片地）             
tractable adj. 易管教的    
	tract 拉，拖 + able 能…的 → 能够拉〔回来〕→ 易管教的             
tractor n. 拖拉机


con
contrast	n.差异，对照，对比，对照，对比；与...对比

ad-		at-	朝向，去
-equ(a)- 	equal	相等的
adequate	"去变的相等"	足够的，胜任的

as
assure		v..保证
assurance	n.信心；保证

in		进入
fer		带来，拿来
infer		带进->推理 ；做出推论

ampl		拿
e
ample		拿多了的->充足的；丰裕的；丰满的；硕大的

can
did
ate
candidate	能做又能吃->候选人


ex		超出
cess		行动
ive
excess		超出规定的->过量的
excessive	超出规定的->过分的
excessively	超出规定的->过分地


share		股份
holder		持有人
shareholder	股份持有人->股东

clar		clear
(i)fy		
clarify		净化，澄清，阐明

de		不
fect		做
defect		没做好->缺点

vacu		空
um		表名词
vacuum		空虚，真空


ac		使
complish	填满
accomplish	使填满	->	完成

tuit		保护
ion	
tuition		学费

sub		下 子
sid		sit	坐
y		表结果		补助；津贴

af		at->ad	朝向，去
firm		坚定
ate
affirmate 	去坚定->主张；肯定；断言
affirmation	去坚定->主张；肯定；断言

in 		使…
form 		形式 
inform		→ 使〔大家知道的〕形式 → 通知
informate	→ 使〔大家知道的〕形式 → 通知
information	信息

dens		vi.边浓厚
dense		adj.浓密的
density		n.密集；密度


drain		v.排空；（使）流光；放干；（使）流干；流出；喝光；喝干		n.下水道；排水道；下水道孔盖；消耗；耗费
age		行为或行为的结果
drainage	n.排水系统
